2000000000000011000000000000000000000000
0001001110010001000111011111011111111110
0111111010011101000001010001000100000100
0100001011110001111101111001000100111111
0100101000000001000101000001000100010000
0101101011110001000101100001000110010000
0101001010011111000100100001000011110000
0001011010000001000100100001111010000000
0001010010111101110100100100001010010100
0111010000010101010100100000111011111110
0101011111010100010100100010000010101010
0001000001010100110100100010010010000000
0011101111010001100110100010000011100000
0000101000010000000000110110010000000000
0011101111111111111011000001110000010000
0010000000000000010001000001000101001000
0011111000111110010001011111100101001000
0000001000000010011101010000000111111000
0111001101101110000100010000000100000000
0100010000101000011110111111111101111101
0101000000111000000000000010000101010001
0101011111100011111111100000000001011101
0101110000000010000010111111110111001000
0100010010000010010010010010000000001010
0110111011111111110010011011111111001000
0000010000100000000011100000000100001100
0000010000100000000000000000010000000003